0 0 0 0 0 0 0 0 0 0 0 0 0 
0 0 0 0 0 0 0 0 0 0 0 0 0 
0 0 0 0 0 0 0 1 1 0 0 0 0 
0 0 0 0 0 0 0 1 1 0 0 0 0 
0 0 0 0 0 0 0 1 1 0 0 0 0 
0 0 0 0 0 0 0 1 1 0 0 0 0 
1 0 0 0 0 0 0 1 1 0 0 0 0 
0 1 0 0 0 0 0 1 1 0 0 0 0 
0 0 1 0 0 0 0 1 1 0 0 0 0 
1 1 1 1 1 1 1 1 1 0 0 0 0 
1 1 1 1 1 1 1 1 1 0 0 0 0 
0 0 0 0 1 0 0 1 1 0 0 0 0 
0 0 0 0 1 0 0 1 1 0 0 0 0 
0 0 0 0 1 0 0 1 1 0 0 0 0 
0 0 0 0 1 0 0 1 1 0 0 0 0 
0 0 0 0 1 0 0 1 1 0 0 0 0 
0 0 0 0 1 0 0 1 1 0 0 0 0 
-
0 0 0 0 0 0 0 0 0 0 0 0 0 
0 0 0 0 0 0 0 0 0 0 0 0 0 
0 0 0 0 0 0 0 0 0 0 0 0 0 
0 0 0 0 0 0 0 0 0 0 0 0 0 
0 0 0 0 0 0 0 0 0 0 0 0 0 
0 0 0 0 0 0 0 0 0 0 0 0 0 
0 0 0 0 0 0 0 0 0 0 0 0 0 
0 0 0 0 0 0 0 0 0 0 0 0 0 
0 0 0 0 0 0 0 0 0 0 0 0 0 
0 0 0 0 0 0 0 0 0 0 0 0 0 
0 0 0 0 0 0 0 0 0 0 0 0 0 
0 0 0 0 0 0 0 0 0 0 0 0 0 
0 0 0 0 0 0 0 0 0 0 0 0 0 
0 0 0 0 0 0 0 0 0 0 0 0 0 
0 0 0 0 0 0 0 0 0 0 0 0 0 
0 0 0 0 0 0 0 0 0 0 0 0 0 
0 0 0 0 0 0 0 0 0 0 0 0 0 
-
0 0 0 0 0 0 0 0 0 0 0 0 0 
0 0 0 0 0 0 0 0 0 0 0 0 0 
27 27 27 27 27 27 27 27 4 6 0 0 0 
0 0 0 0 0 0 0 0 11 22 0 0 0 
0 0 0 0 0 0 0 0 11 22 0 0 0 
0 0 0 0 0 0 0 0 11 22 0 0 0 
0 0 0 0 0 0 0 0 11 22 0 0 0 
0 0 0 0 0 0 0 0 11 22 0 0 0 
0 0 0 0 0 0 0 0 11 22 0 0 0 
0 0 0 0 0 0 0 0 11 22 0 0 0 
0 0 0 0 0 0 0 0 11 22 0 0 0 
0 0 0 0 0 0 0 0 11 22 0 0 0 
0 0 0 0 0 0 0 0 11 22 0 0 0 
0 0 0 0 0 0 0 0 11 22 0 0 0 
0 0 0 0 0 0 0 0 11 22 0 0 0 
0 0 0 0 0 0 0 0 11 22 0 0 0 
0 0 0 0 0 0 0 0 11 22 0 0 0 
