0 0 0 0 0 0 0 0 0 0 0 0 0 
1 1 1 1 1 1 1 1 1 1 1 0 0 
1 1 1 1 1 1 1 1 1 1 1 0 0 
1 1 1 1 1 1 1 1 1 1 1 0 0 
1 1 1 1 1 1 1 1 1 1 1 0 0 
1 1 1 1 1 1 1 1 1 1 1 0 0 
0 0 0 1 1 1 1 1 1 1 1 0 0 
0 0 0 1 1 1 1 1 1 1 1 0 0 
0 0 0 1 1 1 1 1 1 1 1 0 0 
0 0 0 1 1 1 1 1 1 1 1 0 0 
1 1 1 1 1 1 1 1 1 1 1 0 0 
1 1 1 1 1 1 1 1 1 1 1 0 0 
1 1 1 1 1 1 1 1 1 1 1 0 0 
0 0 0 0 0 1 1 1 1 0 0 0 0 
0 0 0 0 0 1 1 1 1 0 0 0 0 
0 0 0 0 0 1 1 1 1 0 0 0 0 
0 0 0 0 0 1 1 1 1 0 0 0 0 
-
0 0 0 0 0 0 0 0 0 0 0 0 0 
0 0 0 0 0 0 0 0 0 0 0 0 0 
0 0 0 0 0 0 0 0 0 0 0 0 0 
0 0 0 0 0 0 0 0 0 0 0 0 0 
0 0 0 0 0 0 0 0 0 0 0 0 0 
0 0 0 0 0 0 0 0 0 0 0 0 0 
0 0 0 0 0 0 0 0 0 0 0 0 0 
0 0 0 0 0 0 0 0 0 0 0 0 0 
0 0 0 0 0 0 0 0 0 0 0 0 0 
0 0 0 0 0 0 0 0 0 0 0 0 0 
0 0 0 0 0 0 0 0 0 0 0 0 0 
0 0 0 0 0 0 0 0 0 0 0 0 0 
0 0 0 0 0 0 0 0 0 0 0 0 0 
0 0 0 0 0 0 0 0 0 0 0 0 0 
0 0 0 0 0 0 0 0 0 0 0 0 0 
0 0 0 0 0 0 0 0 0 0 0 0 0 
0 0 0 0 0 0 0 0 0 0 0 0 0 
-
0 0 0 0 0 0 0 0 0 0 0 0 0 
27 27 27 27 27 27 27 27 27 27 4 6 0 
0 0 0 0 0 0 0 0 0 0 10 22 0 
0 0 0 0 0 0 0 0 0 0 10 14 0 
0 0 0 0 0 0 0 0 0 0 10 22 0 
0 0 0 0 0 0 0 0 0 0 10 22 0 
27 4 6 0 0 0 0 0 0 0 20 14 0 
0 20 22 0 0 0 0 0 0 0 20 22 0 
0 31 13 0 0 0 0 0 0 0 20 22 0 
26 5 7 0 0 0 0 0 0 0 20 22 0 
0 0 0 0 0 0 0 0 0 0 20 22 0 
0 0 0 0 0 0 0 0 0 0 31 22 0 
0 0 0 0 0 0 0 0 0 0 30 13 0 
27 27 27 4 6 0 0 0 10 8 27 25 0 
0 0 0 10 22 0 0 0 19 22 0 0 0 
0 0 0 10 22 0 0 0 32 22 0 0 0 
0 0 0 10 14 0 0 0 10 22 0 0 0 
