0 0 0 0 0 0 0 0 0 0 0 0 0 
0 0 0 0 0 0 0 0 0 0 0 0 0 
0 0 0 0 0 0 0 0 0 0 0 0 0 
0 0 0 0 1 1 1 1 1 2 0 0 0 
0 0 0 0 1 1 3 1 1 1 0 0 0 
0 0 0 0 1 1 1 1 1 1 0 0 0 
0 0 0 0 1 1 1 1 1 1 0 0 0 
0 0 0 0 0 0 1 1 0 0 0 0 0 
0 0 0 0 0 0 2 1 0 0 0 0 0 
0 0 0 1 1 1 1 1 1 1 1 0 0 
0 0 0 1 1 1 1 1 1 3 1 0 0 
0 0 0 1 1 1 1 1 1 1 1 0 0 
0 0 0 1 1 1 1 1 1 1 1 0 0 
0 0 0 1 1 1 3 1 1 1 1 0 0 
0 0 0 2 1 1 1 1 1 1 1 0 0 
0 0 0 0 0 0 0 0 0 0 0 0 0 
0 0 0 0 0 0 0 0 0 0 0 0 0 
-
0 0 0 0 0 0 0 0 0 0 0 0 0 
0 0 0 0 0 0 0 0 0 0 0 0 0 
0 0 0 0 0 0 0 0 0 0 0 0 0 
0 0 0 0 0 0 0 0 0 0 0 0 0 
0 0 0 0 0 0 0 0 0 0 0 0 0 
0 0 0 0 0 0 0 0 0 0 0 0 0 
0 0 0 0 0 0 0 0 0 0 0 0 0 
0 0 0 0 0 0 0 0 0 0 0 0 0 
0 0 0 0 0 0 0 0 0 0 0 0 0 
0 0 0 0 0 0 0 0 0 0 0 0 0 
0 0 0 0 0 0 0 0 0 0 0 0 0 
0 0 0 0 0 0 0 0 0 0 0 0 0 
0 0 0 0 0 0 0 0 0 0 0 0 0 
0 0 0 0 0 0 0 0 0 0 0 0 0 
0 0 0 0 0 0 0 0 0 0 0 0 0 
0 0 0 0 0 0 0 0 0 0 0 0 0 
0 0 0 0 0 0 0 0 0 0 0 0 0 
-
0 0 0 0 0 0 0 0 0 0 0 0 0 
0 0 0 0 0 0 0 0 0 0 0 0 0 
0 0 28 26 26 26 26 26 26 26 24 0 0 
0 0 31 22 0 0 0 0 0 31 22 0 0 
0 0 31 22 0 0 0 0 0 31 22 0 0 
0 0 31 22 0 0 0 0 0 31 22 0 0 
0 0 31 22 0 0 0 0 0 31 22 0 0 
0 0 29 27 4 6 0 10 8 27 25 0 0 
0 28 26 26 5 7 0 11 9 26 26 24 0 
0 32 22 0 0 0 0 0 0 0 32 22 0 
0 32 22 0 0 0 0 0 0 0 32 22 0 
0 32 22 0 0 0 0 0 0 0 32 22 0 
0 32 22 0 0 0 0 0 0 0 32 22 0 
0 32 22 0 0 0 0 0 0 0 32 22 0 
0 32 22 0 0 0 0 0 0 0 31 22 0 
0 29 27 27 27 27 27 27 27 27 27 25 0 
0 0 0 0 0 0 0 0 0 0 0 0 0 
