0 0 0 0 0 0 0 0 0 0 0 0 0 
0 0 0 0 0 1 1 1 1 2 0 0 0 
0 0 0 0 0 1 1 3 1 1 0 0 0 
0 0 0 0 0 1 1 1 1 1 0 0 0 
0 0 0 0 0 1 1 1 1 1 0 0 0 
0 0 0 0 0 0 0 0 1 0 0 0 0 
0 0 0 0 0 0 0 0 1 0 0 0 0 
0 0 0 0 0 1 1 1 1 1 0 0 0 
0 0 0 0 0 1 1 3 1 1 0 0 0 
0 0 0 0 0 0 2 0 0 0 0 0 0 
0 0 0 0 0 0 1 0 0 0 0 0 0 
0 0 0 0 0 1 1 1 1 1 0 0 0 
0 0 0 0 0 1 1 1 2 1 0 0 0 
0 0 0 0 0 1 1 1 1 2 0 0 0 
0 0 0 0 0 1 1 1 1 1 0 0 0 
0 0 0 0 0 0 0 0 0 0 0 0 0 
0 0 0 0 0 0 0 0 0 0 0 0 0 
-
0 0 0 0 0 0 0 0 0 0 0 0 0 
0 0 0 0 0 0 0 0 0 0 0 0 0 
0 0 0 0 0 0 0 0 0 0 0 0 0 
0 0 0 0 0 0 0 0 0 0 0 0 0 
0 0 0 0 0 0 0 0 0 0 0 0 0 
0 0 0 0 0 0 0 0 0 0 0 0 0 
0 0 0 0 0 0 0 0 0 0 0 0 0 
0 0 0 0 0 0 0 0 0 0 0 0 0 
0 0 0 0 0 0 0 0 0 0 0 0 0 
0 0 0 0 0 0 0 0 0 0 0 0 0 
0 0 0 0 0 0 0 0 0 0 0 0 0 
0 0 0 0 0 0 0 0 0 0 0 0 0 
0 0 0 0 0 0 0 0 0 0 0 0 0 
0 0 0 0 0 0 0 0 0 0 0 0 0 
0 0 0 0 0 0 0 0 0 0 0 0 0 
0 0 0 0 0 0 0 0 0 0 0 0 0 
0 0 0 0 0 0 0 0 0 0 0 0 0 
-
0 0 0 28 26 26 26 26 26 26 24 0 0 
0 0 0 31 22 0 0 0 0 31 22 0 0 
0 0 0 31 22 0 0 0 0 31 14 0 0 
0 0 0 31 22 0 0 0 0 31 22 0 0 
0 0 0 31 22 0 0 0 0 19 22 0 0 
0 0 0 29 27 27 4 6 19 8 25 0 0 
0 0 0 28 26 26 5 7 19 22 0 0 0 
0 0 0 31 22 0 0 0 29 4 6 0 0 
0 0 0 31 22 0 0 0 0 31 13 0 0 
0 0 0 29 4 6 10 8 27 27 25 0 0 
0 0 0 28 5 7 11 9 26 26 24 0 0 
0 0 0 31 22 0 0 0 0 31 22 0 0 
0 0 0 31 22 0 0 0 0 31 22 0 0 
0 0 0 31 14 0 0 0 0 31 22 0 0 
0 0 0 31 22 0 0 0 0 31 22 0 0 
0 0 0 29 27 27 27 27 27 27 25 0 0 
0 0 0 0 0 0 0 0 0 0 0 0 0 
