0 0 0 0 0 0 0 0 0 0 0 0 0 
0 0 1 1 1 1 1 1 1 1 3 0 0 
0 0 3 1 1 1 2 1 1 1 2 0 0 
0 0 1 1 1 1 1 1 1 1 1 0 0 
0 0 1 1 1 1 1 1 3 1 1 0 0 
0 0 2 1 1 1 1 1 1 1 1 0 0 
0 0 0 0 0 0 1 1 1 1 1 0 0 
0 0 0 0 0 0 1 1 1 1 1 0 0 
0 0 0 0 0 0 1 1 1 1 1 0 0 
0 0 0 0 0 0 1 1 1 1 1 0 0 
0 0 0 0 0 0 1 3 1 1 1 0 0 
0 0 0 0 0 0 1 1 1 1 3 0 0 
0 0 0 0 0 0 1 1 1 1 1 0 0 
0 0 0 0 0 0 1 1 1 2 1 0 0 
0 0 0 0 0 0 1 1 1 1 1 0 0 
0 0 0 0 0 0 0 0 0 0 0 0 0 
0 0 0 0 0 0 0 0 0 0 0 0 0 
-
0 0 0 0 0 0 0 0 0 0 0 0 0 
0 0 0 0 0 0 0 0 0 0 0 0 0 
0 0 0 0 0 0 0 0 0 0 0 0 0 
0 0 0 0 0 0 0 0 0 0 0 0 0 
0 0 0 0 0 0 0 0 0 0 0 0 0 
0 0 0 0 0 0 0 0 0 0 0 0 0 
0 0 0 0 0 0 0 0 0 0 0 0 0 
0 0 0 0 0 0 0 0 0 0 0 0 0 
0 0 0 0 0 0 0 0 0 0 0 0 0 
0 0 0 0 0 0 0 0 0 0 0 0 0 
0 0 0 0 0 0 0 0 0 0 0 0 0 
0 0 0 0 0 0 0 0 0 0 0 0 0 
0 0 0 0 0 0 0 0 0 0 0 0 0 
0 0 0 0 0 0 0 0 0 0 0 0 0 
0 0 0 0 0 0 0 0 0 0 0 0 0 
0 0 0 0 0 0 0 0 0 0 0 0 0 
0 0 0 0 0 0 0 0 0 0 0 0 0 
-
28 26 26 26 26 26 26 26 26 26 26 24 0 
31 22 0 0 0 0 0 0 0 0 31 22 0 
31 13 0 0 0 0 0 0 0 0 31 22 0 
31 22 0 0 0 0 0 0 0 0 31 22 0 
31 22 0 0 0 0 0 0 0 0 31 22 0 
31 22 0 0 0 0 0 0 0 0 31 22 0 
29 27 27 27 4 6 0 0 0 0 31 22 0 
0 0 0 0 31 22 0 0 0 0 31 22 0 
0 0 0 0 31 13 0 0 0 0 31 22 0 
0 0 0 0 31 22 0 0 0 0 31 22 0 
0 0 0 0 31 22 0 0 0 0 31 22 0 
0 0 0 0 31 22 0 0 0 0 31 22 0 
0 0 0 0 31 22 0 0 0 0 31 22 0 
0 0 0 0 31 22 0 0 0 0 31 14 0 
0 0 0 0 31 22 0 0 0 0 31 22 0 
0 0 0 0 29 27 27 27 27 27 27 25 0 
0 0 0 0 0 0 0 0 0 0 0 0 0 
