0 0 0 0 0 0 0 0 0 0 0 0 0 
0 0 1 1 1 0 0 0 1 1 1 0 0 
0 0 1 1 1 0 0 0 1 1 1 0 0 
0 0 1 1 1 0 0 0 1 1 1 0 0 
0 0 1 1 1 0 0 0 1 1 1 0 0 
0 0 1 1 1 0 0 0 1 1 1 0 0 
0 0 0 1 1 0 0 0 0 1 1 0 0 
0 0 0 1 1 0 0 0 0 1 1 0 0 
0 0 0 1 1 0 0 0 0 1 1 0 0 
0 0 0 1 1 0 0 0 0 1 1 0 0 
0 0 0 1 1 0 0 0 0 1 1 0 0 
0 0 1 1 1 1 1 1 1 1 1 0 0 
0 0 1 1 1 1 1 1 1 1 1 0 0 
0 0 1 1 1 1 1 1 1 1 1 0 0 
0 0 1 1 1 1 1 1 1 1 1 0 0 
0 0 0 0 0 0 0 0 0 0 0 0 0 
0 0 0 0 0 0 0 0 0 0 0 0 0 
-
0 0 0 0 0 0 0 0 0 0 0 0 0 
0 0 0 0 0 0 0 0 0 0 0 0 0 
0 0 0 0 0 0 0 0 0 0 0 0 0 
0 0 0 0 0 0 0 0 0 0 0 0 0 
0 0 0 0 0 0 0 0 0 0 0 0 0 
0 0 0 0 0 0 0 0 0 0 0 0 0 
0 0 0 0 0 0 0 0 0 0 0 0 0 
0 0 0 0 0 0 0 0 0 0 0 0 0 
0 0 0 0 0 0 0 0 0 0 0 0 0 
0 0 0 0 0 0 0 0 0 0 0 0 0 
0 0 0 0 0 0 0 0 0 0 0 0 0 
0 0 0 0 0 0 0 0 0 0 0 0 0 
0 0 0 0 0 0 0 0 0 0 0 0 0 
0 0 0 0 0 0 0 0 0 0 0 0 0 
0 0 0 0 0 0 0 0 0 0 0 0 0 
0 0 0 0 0 0 0 0 0 0 0 0 0 
0 0 0 0 0 0 0 0 0 0 0 0 0 
-
28 26 26 26 26 24 28 26 26 26 26 24 0 
31 22 0 0 31 22 31 13 0 0 31 22 0 
31 22 0 0 31 22 31 22 0 0 31 22 0 
31 13 0 0 31 22 31 22 0 0 31 22 0 
31 22 0 0 31 22 31 22 0 0 31 22 0 
31 22 0 0 31 22 31 22 0 0 31 13 0 
29 4 6 0 10 22 29 4 6 0 31 22 0 
0 31 22 0 31 22 0 31 22 0 31 22 0 
0 31 13 0 31 22 0 31 22 0 31 22 0 
0 31 22 0 31 22 0 31 22 0 31 22 0 
28 5 23 0 11 9 26 5 23 0 31 22 0 
31 22 0 0 0 0 0 0 0 0 31 22 0 
31 22 0 0 0 0 0 0 0 0 31 22 0 
31 22 0 0 0 0 0 0 0 0 31 22 0 
31 22 0 0 0 0 0 0 0 0 31 13 0 
29 27 27 27 27 27 27 27 27 27 27 25 0 
0 0 0 0 0 0 0 0 0 0 0 0 0 
